1 1 1 1 1 1 1 1 1 1 1 1 1 1 1 1 1 1 1 1 1 1 1 1 1 1 1 1 1 1 1 1 1 1 1 1 1 1 1 1 1 1 1 1 1 1 1 1 1 1
1 1 1 1 1 1 1 1 1 1 1 1 1 1 1 1 1 1 1 1 1 1 1 1 1 1 1 1 1 1 1 1 1 1 1 1 1 1 1 1 1 1 1 1 1 1 1 1 1 1
1 1 1 1 1 1 1 1 1 1 1 1 1 1 1 1 1 1 1 1 1 1 1 1 1 1 1 1 1 1 1 1 1 1 1 1 1 1 1 1 1 1 1 1 1 1 1 1 1 1
3 3 3 3 3 6 3 3 3 3 3 3 3 3 3 3 3 6 3 3 3 3 6 3 3 3 6 3 3 3 3 3 3 3 3 3 3 3 3 3 3 3 3 3 3 3 3 3 3 3
4 4 4 4 4 4 4 4 4 4 6 4 4 4 4 4 4 4 4 4 4 4 4 4 4 4 4 4 4 3 3 3 3 3 3 3 3 3 3 3 3 6 3 3 3 6 3 3 3 3
4 4 4 4 4 4 4 4 4 4 4 4 4 4 4 4 4 4 4 4 4 4 4 4 4 4 4 4 4 6 3 6 3 6 3 3 3 3 3 3 3 3 3 3 6 3 6 3 6 3
4 4 4 4 4 4 4 4 4 4 4 4 4 4 4 4 4 4 4 4 4 4 4 4 4 4 4 4 4 3 6 3 6 3 3 3 3 3 3 3 3 3 3 3 3 6 3 3 3 3
0 5 0 0 0 0 0 0 0 0 0 0 0 0 0 0 0 5 5 0 0 0 0 0 0 0 4 4 4 0 0 0 5 0 0 5 0 0 0 0 4 4 4 0 0 0 0 0 5 0
0 0 0 0 0 5 0 0 5 0 0 0 0 0 0 0 5 0 0 0 0 0 0 0 5 0 4 4 4 0 5 0 4 4 4 4 4 4 4 4 4 4 4 0 0 5 0 0 0 0
5 0 0 0 0 0 0 0 0 0 5 0 0 5 0 0 0 0 0 5 0 0 0 0 0 0 4 4 4 0 0 4 4 4 4 4 4 4 4 4 4 4 4 0 0 0 0 0 5 0
0 0 0 5 0 0 0 0 5 0 0 0 5 0 0 0 0 5 0 0 0 0 0 0 0 0 4 4 4 0 4 4 4 4 4 4 4 4 4 4 4 4 4 0 0 0 0 0 0 0
0 5 0 0 0 0 0 0 0 0 0 0 0 0 0 0 5 0 5 0 0 0 5 0 0 0 4 4 4 4 4 4 0 0 0 0 0 5 0 0 0 5 0 0 0 0 5 0 0 0
0 0 5 0 0 0 0 0 0 0 0 5 0 0 0 0 0 0 0 0 0 0 0 0 0 0 4 4 4 4 4 0 0 0 0 5 0 0 0 0 5 0 0 0 5 0 0 0 0 0
0 0 0 0 0 0 0 0 0 5 0 0 0 0 5 0 0 5 0 0 0 0 0 5 0 0 4 4 4 4 0 0 5 0 0 0 0 0 5 0 0 0 0 0 0 0 0 0 0 0
0 0 0 0 0 5 0 0 0 0 0 0 0 0 0 0 5 0 0 5 0 0 0 0 0 0 4 4 4 0 0 0 0 0 0 0 0 0 0 0 0 0 0 0 0 0 0 0 5 0
0 0 0 0 0 0 0 0 0 0 5 0 0 5 0 0 0 0 5 0 0 5 0 0 0 4 4 4 0 0 5 0 0 0 0 0 5 0 0 0 0 0 5 0 0 0 0 0 0 0
0 5 0 0 0 0 5 0 0 0 0 0 0 0 0 0 0 5 0 0 0 0 0 0 4 4 4 0 0 5 0 0 0 0 0 0 0 0 5 0 0 5 0 0 0 5 0 5 0 0
0 0 0 0 0 5 0 0 0 5 0 0 0 5 0 0 5 0 5 0 0 0 0 4 4 4 0 0 5 0 0 0 0 0 0 5 0 5 0 0 0 0 0 0 0 0 0 0 0 0
0 0 0 0 0 0 0 0 0 0 0 0 0 0 0 0 0 0 0 0 0 5 0 4 4 4 0 0 0 0 0 5 0 0 0 0 0 0 0 0 0 0 5 0 0 0 5 0 0 0
0 2 2 2 2 2 2 2 2 2 2 2 0 0 5 0 0 5 0 5 0 0 0 4 4 4 0 0 5 0 0 0 0 0 5 0 0 0 5 0 0 0 0 0 0 0 0 0 0 0
0 2 0 0 0 0 0 0 0 0 0 2 0 0 0 0 5 0 0 0 0 0 0 4 4 4 0 5 0 0 5 0 0 0 0 0 0 0 0 0 5 0 0 0 5 0 0 0 0 0
0 2 0 0 0 0 0 0 0 0 0 2 0 5 0 0 0 0 5 0 0 0 0 4 4 4 0 0 0 0 0 5 0 0 0 0 0 0 5 0 0 0 0 0 0 0 0 5 0 0
0 2 0 0 0 0 0 0 0 0 0 2 0 0 0 0 0 5 0 0 0 0 0 4 4 4 0 0 0 5 0 0 0 0 5 0 0 0 0 0 0 0 0 0 0 0 0 0 0 0
0 2 0 0 0 0 0 0 0 0 0 2 0 0 0 0 5 0 5 5 0 0 0 4 4 4 0 5 0 0 0 0 0 0 0 0 0 0 0 0 0 5 0 0 0 0 0 5 0 0
0 2 0 0 0 0 0 0 0 0 0 2 0 0 0 0 0 0 0 0 0 0 5 4 4 4 0 0 0 0 0 5 0 0 0 0 5 0 0 0 0 0 0 5 0 0 0 0 0 0
0 2 0 0 0 0 0 0 0 0 0 2 0 5 0 0 0 5 0 0 0 0 0 4 4 4 0 5 0 0 0 0 0 0 5 0 0 0 0 0 0 0 0 0 0 0 0 0 0 0
0 2 2 2 2 0 0 0 2 2 2 2 0 0 0 0 5 0 0 5 0 5 0 4 4 4 0 0 0 5 0 5 0 0 0 0 0 0 5 0 0 0 0 0 0 0 0 0 0 0
0 0 0 0 0 0 0 0 0 0 0 0 0 0 0 0 0 0 0 0 0 0 0 4 4 4 0 5 0 0 0 0 0 0 0 0 0 0 0 0 0 0 0 0 5 0 0 0 0 0
0 0 0 0 0 4 4 4 0 0 0 0 5 0 0 0 0 0 0 0 5 0 0 4 4 4 0 0 5 0 5 0 5 0 5 0 5 0 5 0 5 0 5 0 0 0 0 0 5 0
0 0 0 0 0 4 4 4 0 5 0 0 0 0 0 5 0 0 0 0 0 0 0 4 4 4 0 0 0 5 0 5 0 5 0 5 0 5 0 5 0 5 0 5 0 0 0 0 0 0
5 0 0 0 0 4 4 4 0 0 0 5 0 0 0 0 0 0 0 0 0 0 0 4 4 4 4 4 4 4 4 4 4 4 4 4 4 4 4 4 4 0 0 0 5 0 0 0 0 0
0 0 5 0 0 4 4 4 0 0 0 0 5 0 0 0 5 0 0 5 0 0 0 4 4 4 4 4 4 4 4 4 4 4 4 4 4 4 4 4 4 4 4 4 0 5 0 0 0 0
0 0 0 0 0 4 4 4 0 5 0 0 0 0 0 0 0 0 0 0 0 0 0 4 4 4 4 4 4 4 4 4 4 4 4 4 4 4 4 4 4 4 4 4 4 0 5 0 0 0
0 0 0 5 0 4 4 4 0 0 0 0 0 0 5 0 0 0 5 0 0 0 5 4 4 4 0 0 0 0 0 0 5 0 0 0 5 0 0 0 0 5 0 4 4 4 0 5 0 0
0 0 0 0 0 4 4 4 0 0 5 0 0 5 0 0 0 0 5 0 0 0 0 4 4 4 0 0 5 0 1 1 1 1 1 1 1 1 1 1 1 0 0 0 4 4 4 0 5 0
0 0 0 0 0 4 4 4 0 0 0 0 0 0 0 0 0 0 0 0 0 0 0 4 4 4 0 0 0 1 1 1 1 1 1 1 1 1 1 1 1 1 1 0 0 4 4 4 0 0
5 0 5 0 0 4 4 4 5 0 0 0 0 5 0 0 0 5 0 0 0 5 0 4 4 4 5 0 1 1 1 1 1 1 1 1 1 1 1 1 1 1 1 1 0 0 4 4 4 0
0 0 0 0 0 4 4 4 4 4 4 4 4 4 4 4 4 4 4 4 4 4 4 4 4 4 0 0 1 1 1 1 1 1 1 1 1 1 1 1 1 1 1 1 0 5 4 4 4 0
0 0 0 0 0 4 4 4 4 4 4 4 4 4 4 4 4 4 4 4 4 4 4 4 4 0 0 1 1 1 1 1 1 1 1 1 1 1 1 1 1 1 1 0 0 0 4 4 4 0
0 5 0 0 0 4 4 4 4 4 4 4 4 4 4 4 4 4 4 4 4 4 4 4 4 4 0 5 1 1 1 1 1 1 1 1 1 1 1 1 1 1 1 1 0 0 4 4 4 0
0 0 0 0 0 0 0 0 0 0 0 0 0 0 0 0 0 0 0 5 0 0 0 4 4 4 0 0 1 1 1 1 1 1 1 1 1 1 1 1 1 1 1 1 5 0 4 4 4 0
0 0 0 5 0 0 0 0 0 5 0 0 0 5 0 5 0 0 0 0 0 5 0 0 4 4 4 0 0 1 1 1 1 1 1 1 1 1 1 1 1 1 1 0 0 4 4 4 5 0
0 5 0 0 0 0 0 0 0 0 0 0 0 0 0 0 0 5 5 0 0 0 0 0 0 4 4 4 0 5 0 5 0 5 0 5 0 5 0 5 0 5 0 0 4 4 4 0 0 0
0 0 0 0 0 0 0 0 0 5 0 0 0 0 0 5 0 0 0 0 0 0 5 0 0 0 4 4 4 0 5 0 5 0 5 0 5 0 5 0 5 0 5 4 4 4 0 5 0 0
0 0 0 0 0 0 0 0 0 0 5 0 0 0 0 0 0 0 5 0 0 0 0 0 5 0 0 4 4 4 4 4 4 4 4 4 4 4 4 4 4 4 4 4 4 0 5 0 0 0
0 0 5 0 0 0 0 0 0 0 0 0 0 5 0 0 0 0 0 0 0 5 0 0 0 0 5 0 4 4 4 4 4 4 4 4 4 4 4 4 4 4 4 4 0 0 5 0 0 0
0 0 0 0 0 0 0 0 0 5 0 0 0 0 5 0 0 0 5 0 0 0 0 0 5 0 5 0 0 5 0 4 4 4 4 4 4 4 4 4 4 0 0 0 5 0 0 0 0 0
0 5 0 0 0 0 0 0 0 0 0 5 0 0 0 0 5 0 0 0 0 0 0 0 0 0 0 5 0 0 0 0 0 0 5 0 5 0 0 0 5 0 5 0 5 0 0 5 0 0
0 0 0 0 5 0 0 5 0 0 0 0 0 0 5 0 0 0 0 0 5 0 0 5 0 0 0 0 5 5 0 5 0 5 0 5 0 5 0 0 0 0 0 0 0 0 0 0 0 0
0 0 0 0 0 0 0 0 5 0 0 0 0 0 0 0 0 0 0 0 0 0 0 0 0 0 0 0 0 0 0 0 0 0 0 0 0 0 0 0 0 0 0 0 0 0 0 0 0 0