1 1 1 1 1 4 3 0 0 0 0 0 0 0 0 0
1 1 1 1 1 4 3 0 0 0 0 0 0 0 0 0
1 5 1 1 1 4 3 0 0 0 0 0 0 0 0 0
1 1 1 1 1 4 3 0 0 0 0 0 0 0 0 0
1 1 1 1 1 4 3 0 0 0 0 0 0 0 0 0
1 1 1 1 1 4 3 3 3 3 3 3 3 3 3 3
1 1 1 1 1 4 4 4 4 4 4 4 4 4 4 4
1 1 1 1 1 4 1 1 1 1 1 1 5 1 1 1
1 5 1 1 1 4 1 1 1 1 1 1 1 1 1 1
1 1 1 1 1 4 1 1 1 1 1 1 1 5 1 1
1 1 1 1 1 4 1 1 1 5 1 1 1 1 1 1
1 1 1 1 1 4 1 1 1 1 1 1 1 1 1 1